w.p..w...w..w
w.x.ww..x.w.w
.w..w...x..p.
.ww..*.w.wwww
.......w....w
..xw......x.w
...p..w....ww
ww...ww.xwww.
.px..w.x..ww.
....ww...wwww
..p...x...p.w
.x.wwww...www
wwwwwwwwwwwww